The rows:70
The columns:58
The start:47,14
The end:37,13
The maze:
¡ö¡õ¡ö¡õ¡ö¡õ¡ö¡ö¡õ¡õ¡ö¡õ¡ö¡õ¡ö¡ö¡õ¡õ¡ö¡õ¡ö¡õ¡õ¡õ¡õ¡õ¡ö¡õ¡ö¡ö¡ö¡ö¡õ¡ö¡ö¡ö¡õ¡ö¡ö¡õ¡ö¡õ¡ö¡ö¡ö¡õ¡õ¡õ¡ö¡õ¡õ¡õ¡ö¡ö¡ö¡õ¡ö¡õ
¡ö¡ö¡ö¡ö¡õ¡õ¡õ¡ö¡ö¡ö¡ö¡ö¡õ¡õ¡õ¡õ¡õ¡õ¡ö¡õ¡õ¡ö¡õ¡ö¡õ¡ö¡ö¡õ¡õ¡õ¡õ¡õ¡ö¡ö¡ö¡õ¡ö¡õ¡ö¡õ¡ö¡õ¡õ¡õ¡ö¡õ¡ö¡õ¡ö¡ö¡ö¡ö¡õ¡ö¡ö¡õ¡õ¡ö
¡ö¡ö¡ö¡õ¡ö¡ö¡õ¡õ¡ö¡ö¡õ¡ö¡õ¡ö¡ö¡ö¡ö¡ö¡ö¡õ¡õ¡õ¡ö¡ö¡ö¡ö¡ö¡ö¡ö¡ö¡ö¡õ¡õ¡õ¡ö¡õ¡ö¡ö¡ö¡ö¡ö¡ö¡ö¡ö¡ö¡ö¡ö¡ö¡ö¡õ¡ö¡õ¡ö¡ö¡õ¡õ¡õ¡ö
¡ö¡õ¡õ¡ö¡ö¡õ¡ö¡ö¡ö¡õ¡õ¡õ¡ö¡õ¡õ¡ö¡ö¡õ¡õ¡ö¡ö¡õ¡ö¡õ¡ö¡õ¡ö¡ö¡õ¡õ¡ö¡ö¡õ¡ö¡ö¡ö¡ö¡õ¡õ¡õ¡ö¡õ¡ö¡ö¡õ¡ö¡ö¡õ¡ö¡õ¡õ¡õ¡õ¡ö¡ö¡ö¡ö¡ö
¡õ¡õ¡õ¡ö¡ö¡õ¡ö¡õ¡õ¡õ¡ö¡õ¡ö¡õ¡ö¡ö¡õ¡ö¡õ¡õ¡õ¡ö¡õ¡ö¡ö¡õ¡ö¡õ¡ö¡õ¡õ¡ö¡õ¡õ¡ö¡õ¡õ¡õ¡ö¡õ¡ö¡ö¡õ¡õ¡õ¡ö¡õ¡ö¡ö¡õ¡õ¡õ¡ö¡ö¡õ¡õ¡õ¡ö
¡ö¡ö¡õ¡õ¡ö¡õ¡ö¡õ¡õ¡ö¡õ¡õ¡ö¡õ¡ö¡ö¡ö¡õ¡õ¡õ¡õ¡ö¡ö¡õ¡ö¡ö¡õ¡õ¡ö¡ö¡ö¡ö¡õ¡õ¡õ¡õ¡ö¡ö¡õ¡ö¡ö¡õ¡ö¡ö¡ö¡õ¡õ¡ö¡õ¡õ¡ö¡ö¡ö¡ö¡õ¡õ¡ö¡õ
¡õ¡ö¡ö¡ö¡õ¡ö¡õ¡ö¡ö¡ö¡õ¡õ¡õ¡õ¡õ¡õ¡ö¡õ¡õ¡ö¡õ¡õ¡õ¡õ¡ö¡ö¡ö¡õ¡ö¡õ¡ö¡õ¡ö¡õ¡õ¡ö¡õ¡ö¡õ¡õ¡õ¡ö¡õ¡ö¡ö¡õ¡ö¡ö¡ö¡õ¡õ¡ö¡õ¡ö¡ö¡õ¡ö¡õ
¡ö¡õ¡õ¡ö¡õ¡ö¡ö¡õ¡õ¡ö¡ö¡ö¡ö¡ö¡ö¡ö¡ö¡õ¡ö¡ö¡õ¡ö¡ö¡õ¡õ¡õ¡ö¡õ¡õ¡ö¡õ¡õ¡õ¡ö¡ö¡õ¡õ¡ö¡ö¡ö¡ö¡ö¡ö¡ö¡õ¡ö¡ö¡ö¡ö¡ö¡õ¡ö¡ö¡õ¡ö¡ö¡ö¡õ
¡õ¡õ¡õ¡ö¡õ¡õ¡õ¡ö¡ö¡õ¡õ¡õ¡õ¡õ¡ö¡õ¡ö¡õ¡ö¡õ¡õ¡ö¡õ¡õ¡ö¡ö¡õ¡õ¡ö¡ö¡ö¡õ¡ö¡õ¡õ¡ö¡ö¡õ¡ö¡ö¡õ¡õ¡ö¡õ¡õ¡õ¡õ¡ö¡ö¡õ¡õ¡ö¡õ¡õ¡ö¡ö¡õ¡ö
¡ö¡õ¡õ¡ö¡ö¡õ¡õ¡ö¡õ¡õ¡õ¡ö¡ö¡ö¡õ¡ö¡ö¡õ¡ö¡ö¡õ¡õ¡ö¡õ¡ö¡ö¡õ¡ö¡ö¡ö¡ö¡õ¡õ¡ö¡õ¡õ¡ö¡ö¡ö¡õ¡õ¡õ¡ö¡ö¡ö¡õ¡õ¡õ¡ö¡ö¡õ¡õ¡ö¡õ¡õ¡õ¡õ¡õ
¡õ¡õ¡ö¡õ¡ö¡ö¡õ¡ö¡ö¡ö¡õ¡õ¡õ¡õ¡õ¡ö¡õ¡ö¡ö¡ö¡ö¡ö¡õ¡ö¡ö¡ö¡ö¡ö¡ö¡ö¡ö¡õ¡õ¡ö¡ö¡õ¡ö¡ö¡õ¡ö¡õ¡ö¡ö¡ö¡õ¡õ¡õ¡ö¡ö¡ö¡ö¡õ¡õ¡ö¡õ¡ö¡õ¡ö
¡ö¡ö¡õ¡õ¡õ¡õ¡ö¡ö¡õ¡ö¡ö¡ö¡ö¡ö¡õ¡ö¡õ¡ö¡ö¡õ¡õ¡õ¡ö¡ö¡õ¡ö¡õ¡ö¡õ¡ö¡ö¡õ¡õ¡õ¡ö¡õ¡ö¡ö¡õ¡õ¡õ¡ö¡ö¡õ¡ö¡ö¡ö¡õ¡õ¡ö¡ö¡ö¡ö¡ö¡ö¡ö¡ö¡õ
¡õ¡õ¡õ¡ö¡ö¡ö¡õ¡õ¡õ¡õ¡õ¡ö¡ö¡ö¡ö¡õ¡õ¡ö¡ö¡ö¡ö¡õ¡õ¡õ¡õ¡õ¡õ¡õ¡ö¡ö¡õ¡ö¡ö¡ö¡õ¡ö¡õ¡ö¡õ¡ö¡ö¡ö¡õ¡ö¡õ¡õ¡ö¡õ¡õ¡õ¡ö¡ö¡ö¡õ¡õ¡ö¡ö¡õ
¡õ¡ö¡ö¡õ¡õ¡ö¡õ¡ö¡õ¡ö¡õ¡ö¡ö¡ö¡õ¡õ¡õ¡ö¡ö¡ö¡ö¡ö¡ö¡õ¡ö¡ö¡ö¡õ¡ö¡õ¡ö¡õ¡ö¡õ¡ö¡ö¡ö¡ö¡õ¡ö¡ö¡õ¡ö¡õ¡ö¡ö¡ö¡ö¡ö¡ö¡õ¡ö¡ö¡õ¡ö¡õ¡ö¡ö
¡ö¡õ¡õ¡õ¡ö¡ö¡õ¡ö¡õ¡õ¡õ¡ö¡ö¡õ¡ö¡õ¡ö¡õ¡ö¡ö¡ö¡ö¡ö¡ö¡õ¡ö¡ö¡ö¡ö¡ö¡õ¡õ¡ö¡ö¡ö¡ö¡õ¡õ¡ö¡õ¡õ¡õ¡õ¡õ¡ö¡ö¡õ¡õ¡ö¡õ¡ö¡õ¡ö¡ö¡õ¡ö¡õ¡ö
¡õ¡ö¡õ¡õ¡õ¡õ¡õ¡õ¡õ¡ö¡ö¡õ¡õ¡ö¡ö¡ö¡ö¡õ¡õ¡õ¡ö¡ö¡õ¡õ¡õ¡ö¡õ¡õ¡ö¡ö¡õ¡ö¡ö¡ö¡õ¡õ¡ö¡ö¡ö¡ö¡õ¡õ¡ö¡õ¡ö¡õ¡õ¡ö¡õ¡ö¡ö¡õ¡ö¡ö¡ö¡õ¡ö¡õ
¡õ¡ö¡ö¡õ¡õ¡õ¡õ¡ö¡ö¡õ¡õ¡ö¡õ¡õ¡õ¡õ¡ö¡õ¡ö¡ö¡õ¡õ¡õ¡ö¡õ¡õ¡õ¡õ¡õ¡ö¡õ¡ö¡ö¡ö¡õ¡õ¡õ¡õ¡õ¡ö¡ö¡õ¡õ¡õ¡ö¡õ¡ö¡ö¡õ¡ö¡õ¡ö¡ö¡õ¡ö¡õ¡ö¡ö
¡ö¡õ¡ö¡õ¡õ¡ö¡õ¡ö¡ö¡õ¡ö¡õ¡õ¡õ¡ö¡ö¡ö¡õ¡õ¡ö¡õ¡ö¡õ¡õ¡õ¡õ¡ö¡õ¡õ¡õ¡ö¡õ¡ö¡ö¡ö¡õ¡õ¡ö¡õ¡õ¡ö¡ö¡õ¡ö¡õ¡ö¡ö¡ö¡ö¡ö¡õ¡õ¡ö¡õ¡ö¡õ¡õ¡ö
¡ö¡õ¡õ¡õ¡ö¡õ¡õ¡õ¡õ¡õ¡õ¡ö¡õ¡ö¡ö¡ö¡õ¡õ¡ö¡õ¡ö¡õ¡ö¡õ¡õ¡õ¡õ¡ö¡õ¡õ¡ö¡ö¡ö¡ö¡ö¡õ¡ö¡õ¡ö¡õ¡õ¡õ¡õ¡õ¡õ¡õ¡ö¡õ¡õ¡õ¡ö¡õ¡õ¡ö¡ö¡õ¡ö¡õ
¡õ¡õ¡ö¡ö¡ö¡õ¡ö¡õ¡õ¡ö¡ö¡õ¡ö¡ö¡õ¡õ¡ö¡õ¡õ¡õ¡ö¡õ¡ö¡ö¡ö¡ö¡õ¡ö¡ö¡ö¡õ¡ö¡õ¡ö¡õ¡õ¡ö¡õ¡ö¡ö¡ö¡õ¡õ¡ö¡õ¡õ¡õ¡õ¡õ¡ö¡õ¡õ¡õ¡ö¡õ¡õ¡õ¡ö
¡õ¡õ¡ö¡õ¡õ¡õ¡õ¡õ¡õ¡ö¡õ¡õ¡õ¡õ¡ö¡ö¡õ¡õ¡õ¡ö¡ö¡ö¡õ¡ö¡õ¡ö¡ö¡õ¡õ¡ö¡õ¡õ¡ö¡õ¡õ¡ö¡õ¡õ¡ö¡ö¡ö¡ö¡õ¡õ¡ö¡ö¡ö¡õ¡ö¡õ¡õ¡õ¡ö¡ö¡õ¡õ¡õ¡õ
¡ö¡õ¡õ¡ö¡õ¡õ¡õ¡õ¡ö¡õ¡ö¡õ¡õ¡õ¡õ¡õ¡ö¡ö¡õ¡õ¡ö¡õ¡õ¡õ¡ö¡ö¡õ¡õ¡õ¡õ¡õ¡ö¡õ¡ö¡õ¡õ¡õ¡ö¡ö¡õ¡õ¡ö¡õ¡õ¡ö¡ö¡ö¡õ¡õ¡ö¡ö¡õ¡õ¡õ¡ö¡ö¡õ¡õ
¡ö¡õ¡õ¡ö¡õ¡ö¡ö¡õ¡õ¡ö¡ö¡õ¡õ¡ö¡õ¡ö¡ö¡ö¡ö¡ö¡õ¡õ¡õ¡ö¡õ¡õ¡õ¡õ¡õ¡õ¡ö¡õ¡õ¡ö¡ö¡õ¡õ¡õ¡ö¡ö¡ö¡ö¡õ¡ö¡ö¡ö¡õ¡õ¡õ¡ö¡ö¡ö¡õ¡ö¡õ¡ö¡õ¡õ
¡õ¡ö¡õ¡õ¡õ¡ö¡õ¡õ¡õ¡ö¡õ¡ö¡õ¡õ¡ö¡ö¡õ¡ö¡õ¡õ¡õ¡ö¡õ¡õ¡ö¡ö¡ö¡ö¡ö¡ö¡ö¡ö¡ö¡ö¡ö¡õ¡ö¡õ¡ö¡ö¡ö¡ö¡õ¡õ¡õ¡ö¡õ¡õ¡ö¡ö¡ö¡õ¡ö¡ö¡ö¡õ¡ö¡õ
¡õ¡õ¡ö¡ö¡ö¡ö¡ö¡õ¡õ¡õ¡ö¡õ¡ö¡ö¡ö¡ö¡õ¡õ¡õ¡ö¡ö¡õ¡ö¡ö¡õ¡ö¡ö¡õ¡ö¡ö¡õ¡õ¡ö¡ö¡õ¡õ¡ö¡õ¡ö¡õ¡ö¡ö¡õ¡ö¡ö¡ö¡ö¡ö¡ö¡õ¡ö¡õ¡õ¡õ¡õ¡ö¡ö¡õ
¡ö¡ö¡ö¡õ¡ö¡ö¡õ¡õ¡ö¡õ¡õ¡õ¡õ¡ö¡õ¡õ¡õ¡ö¡ö¡õ¡ö¡ö¡õ¡ö¡ö¡ö¡õ¡õ¡õ¡ö¡õ¡õ¡õ¡ö¡ö¡ö¡ö¡ö¡õ¡õ¡ö¡õ¡õ¡ö¡ö¡ö¡õ¡õ¡õ¡õ¡ö¡ö¡õ¡õ¡ö¡õ¡ö¡õ
¡ö¡õ¡ö¡ö¡õ¡õ¡õ¡ö¡õ¡õ¡õ¡ö¡ö¡õ¡õ¡ö¡ö¡õ¡õ¡õ¡ö¡õ¡õ¡õ¡õ¡ö¡ö¡ö¡õ¡ö¡õ¡õ¡ö¡ö¡ö¡õ¡õ¡õ¡õ¡õ¡õ¡ö¡ö¡ö¡ö¡ö¡ö¡ö¡ö¡ö¡ö¡ö¡ö¡ö¡ö¡ö¡õ¡ö
¡õ¡õ¡õ¡ö¡ö¡ö¡ö¡õ¡õ¡õ¡ö¡ö¡ö¡õ¡ö¡ö¡ö¡õ¡õ¡õ¡ö¡õ¡ö¡ö¡ö¡õ¡ö¡õ¡õ¡ö¡ö¡õ¡õ¡õ¡ö¡õ¡õ¡ö¡ö¡ö¡õ¡õ¡ö¡õ¡ö¡õ¡õ¡ö¡õ¡ö¡ö¡õ¡õ¡õ¡õ¡ö¡ö¡õ
¡ö¡ö¡ö¡ö¡õ¡õ¡õ¡ö¡ö¡õ¡ö¡õ¡ö¡õ¡õ¡õ¡õ¡õ¡õ¡õ¡ö¡õ¡ö¡õ¡ö¡õ¡ö¡ö¡ö¡ö¡ö¡õ¡ö¡ö¡ö¡ö¡ö¡õ¡õ¡ö¡õ¡õ¡ö¡õ¡õ¡õ¡ö¡ö¡ö¡õ¡ö¡õ¡õ¡ö¡õ¡ö¡õ¡õ
¡ö¡ö¡ö¡ö¡õ¡õ¡õ¡ö¡ö¡ö¡ö¡õ¡õ¡õ¡ö¡ö¡ö¡õ¡ö¡ö¡ö¡ö¡õ¡õ¡ö¡õ¡õ¡õ¡õ¡õ¡õ¡ö¡õ¡õ¡ö¡ö¡ö¡õ¡õ¡õ¡õ¡ö¡õ¡õ¡ö¡õ¡ö¡õ¡õ¡õ¡ö¡õ¡ö¡õ¡ö¡ö¡ö¡õ
¡ö¡ö¡õ¡ö¡ö¡ö¡ö¡ö¡õ¡ö¡õ¡õ¡õ¡ö¡õ¡ö¡õ¡ö¡õ¡ö¡õ¡õ¡õ¡ö¡ö¡ö¡õ¡ö¡ö¡ö¡õ¡õ¡ö¡ö¡õ¡õ¡õ¡ö¡ö¡õ¡ö¡õ¡õ¡õ¡ö¡ö¡ö¡ö¡õ¡õ¡õ¡ö¡õ¡ö¡õ¡ö¡õ¡õ
¡õ¡õ¡ö¡ö¡õ¡õ¡ö¡õ¡õ¡ö¡õ¡ö¡õ¡ö¡ö¡ö¡õ¡ö¡õ¡ö¡õ¡ö¡õ¡ö¡ö¡ö¡ö¡ö¡õ¡ö¡ö¡õ¡õ¡õ¡ö¡ö¡ö¡õ¡ö¡ö¡ö¡ö¡ö¡ö¡õ¡õ¡õ¡õ¡õ¡ö¡ö¡ö¡õ¡õ¡õ¡õ¡ö¡ö
¡õ¡õ¡ö¡ö¡ö¡õ¡õ¡õ¡ö¡õ¡õ¡ö¡õ¡ö¡ö¡õ¡ö¡ö¡õ¡ö¡õ¡õ¡õ¡õ¡õ¡õ¡õ¡õ¡ö¡õ¡õ¡õ¡ö¡ö¡õ¡õ¡ö¡õ¡ö¡õ¡ö¡ö¡õ¡ö¡õ¡ö¡õ¡õ¡õ¡õ¡ö¡õ¡ö¡ö¡ö¡õ¡ö¡õ
¡õ¡õ¡õ¡ö¡õ¡ö¡õ¡õ¡ö¡õ¡ö¡õ¡õ¡ö¡ö¡õ¡ö¡ö¡ö¡õ¡õ¡ö¡ö¡õ¡õ¡ö¡õ¡ö¡õ¡ö¡ö¡õ¡õ¡ö¡õ¡õ¡ö¡õ¡õ¡ö¡ö¡õ¡ö¡ö¡ö¡õ¡õ¡ö¡õ¡õ¡õ¡õ¡õ¡ö¡õ¡õ¡õ¡ö
¡õ¡õ¡õ¡ö¡ö¡õ¡õ¡ö¡õ¡õ¡ö¡ö¡õ¡õ¡õ¡õ¡ö¡ö¡ö¡õ¡ö¡ö¡õ¡õ¡ö¡õ¡õ¡õ¡ö¡ö¡ö¡õ¡ö¡õ¡õ¡õ¡õ¡ö¡õ¡õ¡ö¡õ¡õ¡ö¡õ¡õ¡ö¡ö¡õ¡ö¡ö¡õ¡õ¡õ¡ö¡ö¡ö¡õ
¡ö¡õ¡ö¡ö¡ö¡ö¡ö¡õ¡õ¡õ¡õ¡õ¡õ¡ö¡õ¡ö¡õ¡ö¡õ¡ö¡ö¡ö¡ö¡õ¡ö¡õ¡ö¡ö¡õ¡õ¡õ¡ö¡õ¡ö¡ö¡õ¡ö¡ö¡õ¡õ¡õ¡ö¡õ¡ö¡ö¡ö¡õ¡õ¡ö¡ö¡ö¡õ¡õ¡ö¡ö¡ö¡õ¡ö
¡ö¡ö¡õ¡ö¡õ¡ö¡õ¡õ¡ö¡ö¡õ¡õ¡ö¡ö¡ö¡õ¡õ¡ö¡õ¡õ¡õ¡õ¡ö¡õ¡ö¡ö¡ö¡õ¡ö¡ö¡ö¡ö¡õ¡ö¡ö¡ö¡õ¡ö¡ö¡ö¡ö¡ö¡õ¡õ¡ö¡õ¡õ¡ö¡õ¡õ¡õ¡ö¡õ¡ö¡õ¡õ¡õ¡ö
¡ö¡ö¡õ¡ö¡õ¡õ¡õ¡õ¡õ¡õ¡õ¡õ¡ö¡õ¡ö¡õ¡õ¡ö¡ö¡ö¡ö¡ö¡ö¡ö¡ö¡õ¡õ¡õ¡ö¡ö¡õ¡ö¡õ¡ö¡ö¡õ¡ö¡õ¡õ¡ö¡ö¡ö¡õ¡ö¡õ¡ö¡ö¡õ¡õ¡ö¡õ¡õ¡ö¡ö¡ö¡õ¡õ¡ö
¡õ¡õ¡ö¡ö¡õ¡õ¡ö¡õ¡ö¡õ¡ö¡ö¡õ¡ö¡ö¡õ¡ö¡ö¡õ¡õ¡ö¡õ¡ö¡ö¡ö¡ö¡ö¡õ¡õ¡õ¡ö¡õ¡ö¡õ¡õ¡õ¡ö¡ö¡ö¡ö¡ö¡õ¡ö¡ö¡õ¡ö¡ö¡ö¡õ¡õ¡ö¡ö¡ö¡õ¡õ¡ö¡ö¡õ
¡ö¡ö¡õ¡õ¡ö¡ö¡õ¡ö¡õ¡õ¡ö¡ö¡õ¡õ¡ö¡ö¡õ¡õ¡ö¡ö¡ö¡õ¡õ¡ö¡ö¡õ¡ö¡ö¡ö¡ö¡ö¡õ¡õ¡õ¡õ¡ö¡ö¡õ¡ö¡õ¡ö¡ö¡õ¡ö¡ö¡ö¡ö¡õ¡õ¡õ¡ö¡õ¡õ¡ö¡ö¡ö¡õ¡õ
¡ö¡õ¡ö¡ö¡õ¡õ¡ö¡õ¡ö¡õ¡ö¡ö¡õ¡õ¡õ¡õ¡õ¡ö¡õ¡õ¡õ¡õ¡ö¡ö¡ö¡ö¡õ¡ö¡ö¡ö¡õ¡ö¡ö¡õ¡ö¡ö¡õ¡õ¡õ¡ö¡ö¡ö¡õ¡ö¡ö¡õ¡ö¡ö¡õ¡õ¡õ¡ö¡õ¡õ¡ö¡õ¡ö¡ö
¡õ¡õ¡õ¡õ¡õ¡õ¡õ¡õ¡õ¡ö¡ö¡ö¡ö¡õ¡õ¡ö¡õ¡õ¡ö¡ö¡õ¡õ¡õ¡ö¡õ¡õ¡ö¡ö¡ö¡ö¡ö¡ö¡ö¡ö¡õ¡ö¡ö¡ö¡ö¡õ¡õ¡ö¡ö¡ö¡ö¡ö¡õ¡õ¡õ¡ö¡õ¡ö¡õ¡ö¡õ¡ö¡õ¡ö
¡õ¡ö¡ö¡õ¡õ¡õ¡õ¡ö¡õ¡ö¡õ¡ö¡õ¡ö¡ö¡ö¡ö¡õ¡ö¡ö¡õ¡ö¡ö¡ö¡õ¡ö¡õ¡õ¡ö¡ö¡ö¡õ¡ö¡ö¡ö¡ö¡õ¡ö¡ö¡õ¡ö¡ö¡ö¡õ¡ö¡ö¡õ¡ö¡õ¡õ¡õ¡õ¡ö¡õ¡ö¡õ¡õ¡õ
¡õ¡ö¡õ¡õ¡ö¡ö¡ö¡ö¡ö¡õ¡õ¡õ¡õ¡õ¡õ¡õ¡õ¡ö¡ö¡õ¡õ¡õ¡õ¡ö¡ö¡ö¡õ¡õ¡ö¡õ¡ö¡ö¡ö¡õ¡ö¡ö¡ö¡ö¡õ¡ö¡õ¡õ¡õ¡õ¡õ¡ö¡õ¡õ¡õ¡õ¡õ¡ö¡ö¡õ¡ö¡õ¡õ¡õ
¡õ¡õ¡õ¡õ¡ö¡ö¡õ¡ö¡õ¡ö¡õ¡õ¡õ¡õ¡õ¡õ¡õ¡ö¡õ¡ö¡ö¡õ¡õ¡õ¡õ¡ö¡õ¡õ¡ö¡ö¡ö¡õ¡õ¡õ¡õ¡ö¡õ¡õ¡ö¡õ¡õ¡ö¡õ¡õ¡õ¡ö¡ö¡õ¡ö¡õ¡ö¡ö¡ö¡ö¡ö¡ö¡õ¡ö
¡õ¡ö¡ö¡õ¡ö¡ö¡ö¡ö¡õ¡ö¡õ¡ö¡õ¡õ¡ö¡ö¡õ¡ö¡õ¡õ¡ö¡ö¡ö¡ö¡ö¡ö¡õ¡õ¡ö¡õ¡õ¡õ¡ö¡ö¡õ¡ö¡ö¡õ¡õ¡ö¡ö¡ö¡õ¡õ¡õ¡ö¡ö¡õ¡ö¡ö¡õ¡ö¡ö¡ö¡õ¡õ¡ö¡ö
¡ö¡õ¡õ¡ö¡õ¡õ¡õ¡õ¡ö¡ö¡ö¡ö¡õ¡ö¡ö¡ö¡ö¡õ¡õ¡ö¡õ¡ö¡ö¡õ¡ö¡ö¡õ¡õ¡ö¡ö¡õ¡ö¡ö¡õ¡õ¡õ¡ö¡ö¡õ¡ö¡ö¡ö¡õ¡õ¡ö¡ö¡õ¡ö¡õ¡ö¡ö¡õ¡ö¡ö¡ö¡õ¡õ¡ö
¡ö¡õ¡õ¡ö¡õ¡ö¡õ¡ö¡ö¡ö¡ö¡õ¡ö¡õ¡ö¡õ¡ö¡ö¡ö¡õ¡ö¡ö¡õ¡õ¡õ¡õ¡ö¡ö¡õ¡õ¡õ¡ö¡õ¡ö¡ö¡õ¡ö¡ö¡õ¡ö¡ö¡õ¡ö¡ö¡õ¡õ¡õ¡ö¡õ¡õ¡ö¡ö¡ö¡ö¡ö¡õ¡ö¡ö
¡õ¡ö¡õ¡õ¡õ¡õ¡ö¡ö¡ö¡õ¡õ¡ö¡õ¡ö¡ö¡õ¡ö¡ö¡õ¡ö¡ö¡õ¡õ¡õ¡ö¡ö¡ö¡ö¡ö¡õ¡õ¡õ¡õ¡õ¡õ¡õ¡ö¡ö¡ö¡õ¡õ¡ö¡õ¡ö¡õ¡ö¡õ¡õ¡ö¡ö¡ö¡õ¡ö¡ö¡õ¡õ¡ö¡ö
¡ö¡ö¡õ¡ö¡õ¡ö¡ö¡õ¡õ¡õ¡õ¡ö¡ö¡ö¡ö¡õ¡õ¡ö¡õ¡ö¡ö¡õ¡õ¡õ¡ö¡ö¡õ¡ö¡õ¡õ¡õ¡ö¡õ¡õ¡õ¡ö¡õ¡ö¡õ¡õ¡ö¡õ¡õ¡ö¡ö¡õ¡õ¡õ¡õ¡ö¡õ¡õ¡õ¡ö¡õ¡ö¡ö¡õ
¡õ¡õ¡õ¡ö¡õ¡õ¡ö¡õ¡õ¡ö¡õ¡ö¡õ¡õ¡õ¡õ¡õ¡ö¡õ¡ö¡ö¡õ¡õ¡õ¡ö¡ö¡õ¡ö¡ö¡õ¡õ¡ö¡ö¡ö¡ö¡ö¡õ¡õ¡õ¡õ¡ö¡ö¡ö¡ö¡ö¡ö¡ö¡õ¡õ¡ö¡ö¡õ¡ö¡ö¡õ¡õ¡õ¡õ
¡õ¡õ¡õ¡õ¡ö¡ö¡õ¡ö¡õ¡õ¡õ¡ö¡õ¡ö¡õ¡õ¡õ¡ö¡ö¡õ¡ö¡õ¡õ¡õ¡õ¡ö¡õ¡ö¡õ¡ö¡ö¡ö¡õ¡õ¡õ¡ö¡õ¡õ¡õ¡ö¡õ¡õ¡õ¡õ¡ö¡ö¡ö¡õ¡ö¡ö¡õ¡õ¡õ¡ö¡õ¡õ¡õ¡õ
¡õ¡õ¡õ¡ö¡õ¡ö¡õ¡ö¡õ¡õ¡ö¡ö¡ö¡õ¡õ¡ö¡ö¡õ¡õ¡õ¡õ¡ö¡ö¡ö¡õ¡õ¡ö¡ö¡ö¡õ¡õ¡ö¡õ¡ö¡õ¡õ¡ö¡õ¡ö¡ö¡ö¡ö¡õ¡ö¡ö¡õ¡õ¡õ¡ö¡õ¡õ¡õ¡õ¡ö¡ö¡õ¡õ¡õ
¡ö¡ö¡õ¡ö¡õ¡ö¡ö¡õ¡õ¡ö¡ö¡ö¡õ¡ö¡õ¡ö¡õ¡õ¡õ¡õ¡õ¡ö¡õ¡ö¡ö¡ö¡ö¡ö¡ö¡ö¡ö¡ö¡õ¡õ¡õ¡õ¡ö¡ö¡ö¡õ¡õ¡ö¡ö¡õ¡ö¡ö¡õ¡ö¡ö¡õ¡ö¡õ¡ö¡ö¡ö¡ö¡ö¡õ
¡ö¡ö¡õ¡õ¡ö¡ö¡ö¡õ¡õ¡õ¡õ¡ö¡õ¡õ¡ö¡õ¡õ¡ö¡ö¡õ¡õ¡ö¡ö¡ö¡ö¡õ¡õ¡ö¡õ¡õ¡ö¡ö¡ö¡ö¡ö¡õ¡õ¡õ¡ö¡ö¡ö¡õ¡ö¡õ¡õ¡ö¡õ¡ö¡ö¡õ¡ö¡ö¡ö¡õ¡õ¡ö¡ö¡ö
¡ö¡ö¡ö¡ö¡õ¡õ¡ö¡õ¡õ¡ö¡ö¡ö¡õ¡õ¡õ¡ö¡õ¡õ¡ö¡õ¡õ¡õ¡ö¡ö¡ö¡õ¡ö¡õ¡ö¡õ¡õ¡õ¡ö¡ö¡ö¡õ¡ö¡ö¡õ¡õ¡ö¡ö¡õ¡ö¡ö¡õ¡õ¡ö¡õ¡ö¡õ¡õ¡ö¡ö¡ö¡ö¡õ¡ö
¡õ¡õ¡õ¡õ¡ö¡õ¡ö¡ö¡ö¡õ¡ö¡õ¡õ¡õ¡ö¡õ¡ö¡õ¡ö¡ö¡õ¡ö¡õ¡ö¡õ¡õ¡ö¡õ¡õ¡ö¡ö¡õ¡õ¡õ¡ö¡õ¡ö¡õ¡ö¡ö¡ö¡õ¡õ¡ö¡ö¡ö¡ö¡õ¡ö¡õ¡õ¡õ¡õ¡õ¡ö¡ö¡ö¡õ
¡ö¡ö¡ö¡õ¡õ¡ö¡õ¡ö¡õ¡õ¡ö¡õ¡õ¡õ¡ö¡ö¡õ¡õ¡õ¡õ¡õ¡õ¡õ¡õ¡õ¡ö¡õ¡ö¡õ¡ö¡ö¡ö¡õ¡õ¡õ¡õ¡õ¡ö¡ö¡õ¡õ¡õ¡õ¡õ¡ö¡ö¡ö¡õ¡õ¡ö¡ö¡õ¡õ¡õ¡õ¡õ¡õ¡õ
¡ö¡ö¡ö¡õ¡ö¡õ¡ö¡õ¡ö¡õ¡õ¡õ¡ö¡õ¡õ¡õ¡ö¡ö¡õ¡õ¡ö¡ö¡ö¡õ¡ö¡ö¡ö¡ö¡õ¡ö¡ö¡ö¡ö¡ö¡õ¡õ¡ö¡õ¡ö¡ö¡ö¡ö¡õ¡ö¡õ¡õ¡ö¡õ¡ö¡ö¡õ¡õ¡ö¡ö¡õ¡õ¡õ¡õ
¡ö¡õ¡ö¡ö¡õ¡õ¡õ¡õ¡õ¡õ¡ö¡õ¡õ¡õ¡õ¡õ¡ö¡õ¡õ¡ö¡ö¡õ¡ö¡ö¡ö¡ö¡ö¡õ¡ö¡ö¡õ¡õ¡õ¡ö¡ö¡õ¡õ¡ö¡ö¡õ¡õ¡õ¡õ¡ö¡õ¡õ¡õ¡õ¡ö¡õ¡õ¡õ¡õ¡õ¡ö¡õ¡õ¡ö
¡ö¡õ¡õ¡ö¡õ¡õ¡õ¡õ¡õ¡ö¡ö¡õ¡õ¡õ¡õ¡õ¡õ¡õ¡õ¡ö¡õ¡ö¡õ¡õ¡õ¡ö¡ö¡ö¡ö¡ö¡õ¡õ¡ö¡õ¡ö¡õ¡õ¡õ¡ö¡ö¡õ¡ö¡ö¡õ¡õ¡õ¡ö¡ö¡ö¡ö¡ö¡ö¡õ¡õ¡õ¡õ¡õ¡ö
¡ö¡ö¡õ¡ö¡ö¡õ¡ö¡ö¡õ¡õ¡õ¡õ¡ö¡õ¡ö¡õ¡ö¡ö¡ö¡õ¡õ¡õ¡õ¡ö¡ö¡õ¡ö¡ö¡õ¡ö¡ö¡ö¡õ¡ö¡ö¡õ¡õ¡ö¡õ¡õ¡ö¡ö¡ö¡õ¡õ¡õ¡õ¡õ¡õ¡õ¡ö¡ö¡ö¡ö¡õ¡õ¡õ¡õ
¡ö¡ö¡õ¡ö¡ö¡õ¡ö¡õ¡ö¡ö¡ö¡õ¡ö¡õ¡õ¡ö¡ö¡õ¡ö¡õ¡õ¡õ¡õ¡õ¡ö¡õ¡õ¡ö¡õ¡õ¡ö¡õ¡õ¡õ¡õ¡õ¡ö¡ö¡ö¡õ¡õ¡õ¡ö¡ö¡õ¡ö¡ö¡ö¡õ¡ö¡ö¡õ¡ö¡õ¡õ¡ö¡ö¡õ
¡õ¡õ¡ö¡õ¡õ¡õ¡ö¡ö¡ö¡ö¡õ¡ö¡õ¡ö¡õ¡ö¡ö¡ö¡ö¡ö¡õ¡ö¡ö¡ö¡ö¡ö¡ö¡ö¡ö¡ö¡ö¡õ¡õ¡ö¡õ¡ö¡ö¡ö¡õ¡ö¡õ¡õ¡ö¡ö¡ö¡ö¡ö¡ö¡ö¡ö¡ö¡õ¡õ¡ö¡õ¡ö¡ö¡ö
¡ö¡õ¡ö¡ö¡õ¡õ¡ö¡õ¡õ¡ö¡õ¡ö¡ö¡õ¡ö¡ö¡õ¡ö¡ö¡õ¡ö¡ö¡õ¡ö¡õ¡ö¡õ¡ö¡õ¡ö¡õ¡õ¡ö¡õ¡ö¡õ¡ö¡õ¡õ¡ö¡õ¡õ¡õ¡ö¡ö¡ö¡ö¡õ¡ö¡õ¡õ¡ö¡õ¡õ¡ö¡ö¡õ¡õ
¡ö¡ö¡ö¡ö¡õ¡õ¡ö¡õ¡õ¡õ¡ö¡õ¡ö¡õ¡ö¡ö¡õ¡ö¡õ¡õ¡ö¡ö¡õ¡ö¡ö¡õ¡õ¡ö¡õ¡õ¡ö¡ö¡ö¡ö¡ö¡õ¡ö¡ö¡õ¡ö¡õ¡õ¡ö¡ö¡õ¡õ¡ö¡õ¡õ¡õ¡õ¡õ¡ö¡ö¡õ¡ö¡õ¡ö
¡ö¡õ¡õ¡ö¡õ¡õ¡õ¡ö¡ö¡ö¡ö¡õ¡õ¡õ¡ö¡õ¡õ¡õ¡õ¡ö¡õ¡õ¡ö¡õ¡õ¡ö¡õ¡ö¡õ¡ö¡õ¡õ¡ö¡ö¡õ¡õ¡õ¡ö¡ö¡ö¡ö¡õ¡ö¡ö¡õ¡ö¡õ¡õ¡ö¡õ¡õ¡ö¡õ¡ö¡õ¡õ¡õ¡õ
¡ö¡ö¡ö¡õ¡õ¡ö¡ö¡ö¡õ¡õ¡ö¡ö¡ö¡ö¡ö¡ö¡ö¡ö¡õ¡ö¡õ¡õ¡ö¡õ¡ö¡ö¡õ¡ö¡ö¡õ¡ö¡õ¡õ¡õ¡ö¡ö¡õ¡õ¡õ¡õ¡ö¡ö¡ö¡õ¡õ¡õ¡õ¡ö¡ö¡ö¡õ¡ö¡õ¡õ¡ö¡õ¡ö¡ö
¡ö¡õ¡ö¡ö¡ö¡õ¡ö¡õ¡ö¡ö¡ö¡ö¡ö¡ö¡ö¡ö¡õ¡ö¡ö¡õ¡ö¡õ¡õ¡ö¡ö¡õ¡ö¡õ¡ö¡õ¡õ¡ö¡ö¡õ¡õ¡ö¡õ¡ö¡ö¡ö¡ö¡ö¡õ¡õ¡õ¡ö¡ö¡õ¡ö¡ö¡ö¡ö¡ö¡ö¡ö¡ö¡ö¡ö
¡ö¡ö¡ö¡ö¡õ¡ö¡õ¡õ¡ö¡õ¡ö¡õ¡ö¡ö¡ö¡ö¡ö¡ö¡ö¡ö¡õ¡õ¡ö¡õ¡õ¡ö¡ö¡ö¡õ¡ö¡õ¡ö¡õ¡ö¡ö¡ö¡ö¡ö¡õ¡ö¡ö¡õ¡õ¡õ¡õ¡õ¡õ¡õ¡õ¡ö¡ö¡õ¡õ¡ö¡õ¡õ¡ö¡õ
The solution:
¡ö¡õ¡ö¡õ¡ö¡õ¡ö¡ö¡õ¡õ¡ö¡õ¡ö¡õ¡ö¡ö¡õ¡õ¡ö¡õ¡ö¡õ¡õ¡õ¡õ¡õ¡ö¡õ¡ö¡ö¡ö¡ö¡õ¡ö¡ö¡ö¡õ¡ö¡ö¡õ¡ö¡õ¡ö¡ö¡ö¡õ¡õ¡õ¡ö¡õ¡õ¡õ¡ö¡ö¡ö¡õ¡ö¡õ
¡ö¡ö¡ö¡ö¡õ¡õ¡õ¡ö¡ö¡ö¡ö¡ö¡õ¡õ¡õ¡õ¡õ¡õ¡ö¡õ¡õ¡ö¡õ¡ö¡õ¡ö¡ö¡õ¡õ¡õ¡õ¡õ¡ö¡ö¡ö¡õ¡ö¡õ¡ö¡õ¡ö¡õ¡õ¡õ¡ö¡õ¡ö¡õ¡ö¡ö¡ö¡ö¡õ¡ö¡ö¡õ¡õ¡ö
¡ö¡ö¡ö¡õ¡ö¡ö¡õ¡õ¡ö¡ö¡õ¡ö¡õ¡ö¡ö¡ö¡ö¡ö¡ö¡õ¡õ¡õ¡ö¡ö¡ö¡ö¡ö¡ö¡ö¡ö¡ö¡õ¡õ¡õ¡ö¡õ¡ö¡ö¡ö¡ö¡ö¡ö¡ö¡ö¡ö¡ö¡ö¡ö¡ö¡õ¡ö¡õ¡ö¡ö¡õ¡õ¡õ¡ö
¡ö¡õ¡õ¡ö¡ö¡õ¡ö¡ö¡ö¡õ¡õ¡õ¡ö¡õ¡õ¡ö¡ö¡õ¡õ¡ö¡ö¡õ¡ö¡õ¡ö¡õ¡ö¡ö¡õ¡õ¡ö¡ö¡õ¡ö¡ö¡ö¡ö¡õ¡õ¡õ¡ö¡õ¡ö¡ö¡õ¡ö¡ö¡õ¡ö¡õ¡õ¡õ¡õ¡ö¡ö¡ö¡ö¡ö
¡õ¡õ¡õ¡ö¡ö¡õ¡ö¡õ¡õ¡õ¡ö¡õ¡ö¡õ¡ö¡ö¡õ¡ö¡õ¡õ¡õ¡ö¡õ¡ö¡ö¡õ¡ö¡õ¡ö¡õ¡õ¡ö¡õ¡õ¡ö¡õ¡õ¡õ¡ö¡õ¡ö¡ö¡õ¡õ¡õ¡ö¡õ¡ö¡ö¡õ¡õ¡õ¡ö¡ö¡õ¡õ¡õ¡ö
¡ö¡ö¡õ¡õ¡ö¡õ¡ö¡õ¡õ¡ö¡õ¡õ¡ö¡õ¡ö¡ö¡ö¡õ¡õ¡õ¡õ¡ö¡ö¡õ¡ö¡ö¡õ¡õ¡ö¡ö¡ö¡ö¡õ¡õ¡õ¡õ¡ö¡ö¡õ¡ö¡ö¡õ¡ö¡ö¡ö¡õ¡õ¡ö¡õ¡õ¡ö¡ö¡ö¡ö¡õ¡õ¡ö¡õ
¡õ¡ö¡ö¡ö¡õ¡ö¡õ¡ö¡ö¡ö¡õ¡õ¡õ¡õ¡õ¡õ¡ö¡õ¡õ¡ö¡õ¡õ¡õ¡õ¡ö¡ö¡ö¡õ¡ö¡õ¡ö¡õ¡ö¡õ¡õ¡ö¡õ¡ö¡õ¡õ¡õ¡ö¡õ¡ö¡ö¡õ¡ö¡ö¡ö¡õ¡õ¡ö¡õ¡ö¡ö¡õ¡ö¡õ
¡ö¡õ¡õ¡ö¡õ¡ö¡ö¡õ¡õ¡ö¡ö¡ö¡ö¡ö¡ö¡ö¡ö¡õ¡ö¡ö¡õ¡ö¡ö¡õ¡õ¡õ¡ö¡õ¡õ¡ö¡õ¡õ¡õ¡ö¡ö¡õ¡õ¡ö¡ö¡ö¡ö¡ö¡ö¡ö¡õ¡ö¡ö¡ö¡ö¡ö¡õ¡ö¡ö¡õ¡ö¡ö¡ö¡õ
¡õ¡õ¡õ¡ö¡õ¡õ¡õ¡ö¡ö¡õ¡õ¡õ¡õ¡õ¡ö¡õ¡ö¡õ¡ö¡õ¡õ¡ö¡õ¡õ¡ö¡ö¡õ¡õ¡ö¡ö¡ö¡õ¡ö¡õ¡õ¡ö¡ö¡õ¡ö¡ö¡õ¡õ¡ö¡õ¡õ¡õ¡õ¡ö¡ö¡õ¡õ¡ö¡õ¡õ¡ö¡ö¡õ¡ö
¡ö¡õ¡õ¡ö¡ö¡õ¡õ¡ö¡õ¡õ¡õ¡ö¡ö¡ö¡õ¡ö¡ö¡õ¡ö¡ö¡õ¡õ¡ö¡õ¡ö¡ö¡õ¡ö¡ö¡ö¡ö¡õ¡õ¡ö¡õ¡õ¡ö¡ö¡ö¡õ¡õ¡õ¡ö¡ö¡ö¡õ¡õ¡õ¡ö¡ö¡õ¡õ¡ö¡õ¡õ¡õ¡õ¡õ
¡õ¡õ¡ö¡õ¡ö¡ö¡õ¡ö¡ö¡ö¡õ¡õ¡õ¡õ¡õ¡ö¡õ¡ö¡ö¡ö¡ö¡ö¡õ¡ö¡ö¡ö¡ö¡ö¡ö¡ö¡ö¡õ¡õ¡ö¡ö¡õ¡ö¡ö¡õ¡ö¡õ¡ö¡ö¡ö¡õ¡õ¡õ¡ö¡ö¡ö¡ö¡õ¡õ¡ö¡õ¡ö¡õ¡ö
¡ö¡ö¡õ¡õ¡õ¡õ¡ö¡ö¡õ¡ö¡ö¡ö¡ö¡ö¡õ¡ö¡õ¡ö¡ö¡õ¡õ¡õ¡ö¡ö¡õ¡ö¡õ¡ö¡õ¡ö¡ö¡õ¡õ¡õ¡ö¡õ¡ö¡ö¡õ¡õ¡õ¡ö¡ö¡õ¡ö¡ö¡ö¡õ¡õ¡ö¡ö¡ö¡ö¡ö¡ö¡ö¡ö¡õ
¡õ¡õ¡õ¡ö¡ö¡ö¡õ¡õ¡õ¡õ¡õ¡ö¡ö¡ö¡ö¡õ¡õ¡ö¡ö¡ö¡ö¡õ¡õ¡õ¡õ¡õ¡õ¡õ¡ö¡ö¡õ¡ö¡ö¡ö¡õ¡ö¡õ¡ö¡õ¡ö¡ö¡ö¡õ¡ö¡õ¡õ¡ö¡õ¡õ¡õ¡ö¡ö¡ö¡õ¡õ¡ö¡ö¡õ
¡õ¡ö¡ö¡õ¡õ¡ö¡õ¡ö¡õ¡ö¡õ¡ö¡ö¡ö¡õ¡õ¡õ¡ö¡ö¡ö¡ö¡ö¡ö¡õ¡ö¡ö¡ö¡õ¡ö¡õ¡ö¡õ¡ö¡õ¡ö¡ö¡ö¡ö¡õ¡ö¡ö¡õ¡ö¡õ¡ö¡ö¡ö¡ö¡ö¡ö¡õ¡ö¡ö¡õ¡ö¡õ¡ö¡ö
¡ö¡õ¡õ¡õ¡ö¡ö¡õ¡ö¡õ¡õ¡õ¡ö¡ö¡õ¡ö¡õ¡ö¡õ¡ö¡ö¡ö¡ö¡ö¡ö¡õ¡ö¡ö¡ö¡ö¡ö¡õ¡õ¡ö¡ö¡ö¡ö¡õ¡õ¡ö¡õ¡õ¡õ¡õ¡õ¡ö¡ö¡õ¡õ¡ö¡õ¡ö¡õ¡ö¡ö¡õ¡ö¡õ¡ö
¡õ¡ö¡õ¡õ¡õ¡õ¡õ¡õ¡õ¡ö¡ö¡õ¡õ¡ö¡ö¡ö¡ö¡õ¡õ¡õ¡ö¡ö¡õ¡õ¡õ¡ö¡õ¡õ¡ö¡ö¡õ¡ö¡ö¡ö¡õ¡õ¡ö¡ö¡ö¡ö¡õ¡õ¡ö¡õ¡ö¡õ¡õ¡ö¡õ¡ö¡ö¡õ¡ö¡ö¡ö¡õ¡ö¡õ
¡õ¡ö¡ö¡õ¡õ¡õ¡õ¡ö¡ö¡õ¡õ¡ö¡õ¡õ¡õ¡õ¡ö¡õ¡ö¡ö¡õ¡õ¡õ¡ö¡õ¡õ¡õ¡õ¡õ¡ö¡õ¡ö¡ö¡ö¡õ¡õ¡õ¡õ¡õ¡ö¡ö¡õ¡õ¡õ¡ö¡õ¡ö¡ö¡õ¡ö¡õ¡ö¡ö¡õ¡ö¡õ¡ö¡ö
¡ö¡õ¡ö¡õ¡õ¡ö¡õ¡ö¡ö¡õ¡ö¡õ¡õ¡õ¡ö¡ö¡ö¡õ¡õ¡ö¡õ¡ö¡õ¡õ¡õ¡õ¡ö¡õ¡õ¡õ¡ö¡õ¡ö¡ö¡ö¡õ¡õ¡ö¡õ¡õ¡ö¡ö¡õ¡ö¡õ¡ö¡ö¡ö¡ö¡ö¡õ¡õ¡ö¡õ¡ö¡õ¡õ¡ö
¡ö¡õ¡õ¡õ¡ö¡õ¡õ¡õ¡õ¡õ¡õ¡ö¡õ¡ö¡ö¡ö¡õ¡õ¡ö¡õ¡ö¡õ¡ö¡õ¡õ¡õ¡õ¡ö¡õ¡õ¡ö¡ö¡ö¡ö¡ö¡õ¡ö¡õ¡ö¡õ¡õ¡õ¡õ¡õ¡õ¡õ¡ö¡õ¡õ¡õ¡ö¡õ¡õ¡ö¡ö¡õ¡ö¡õ
¡õ¡õ¡ö¡ö¡ö¡õ¡ö¡õ¡õ¡ö¡ö¡õ¡ö¡ö¡õ¡õ¡ö¡õ¡õ¡õ¡ö¡õ¡ö¡ö¡ö¡ö¡õ¡ö¡ö¡ö¡õ¡ö¡õ¡ö¡õ¡õ¡ö¡õ¡ö¡ö¡ö¡õ¡õ¡ö¡õ¡õ¡õ¡õ¡õ¡ö¡õ¡õ¡õ¡ö¡õ¡õ¡õ¡ö
¡õ¡õ¡ö¡õ¡õ¡õ¡õ¡õ¡õ¡ö¡õ¡õ¡õ¡õ¡ö¡ö¡õ¡õ¡õ¡ö¡ö¡ö¡õ¡ö¡õ¡ö¡ö¡õ¡õ¡ö¡õ¡õ¡ö¡õ¡õ¡ö¡õ¡õ¡ö¡ö¡ö¡ö¡õ¡õ¡ö¡ö¡ö¡õ¡ö¡õ¡õ¡õ¡ö¡ö¡õ¡õ¡õ¡õ
¡ö¡õ¡õ¡ö¡õ¡õ¡õ¡õ¡ö¡õ¡ö¡õ¡õ¡õ¡õ¡õ¡ö¡ö¡õ¡õ¡ö¡õ¡õ¡õ¡ö¡ö¡õ¡õ¡õ¡õ¡õ¡ö¡õ¡ö¡õ¡õ¡õ¡ö¡ö¡õ¡õ¡ö¡õ¡õ¡ö¡ö¡ö¡õ¡õ¡ö¡ö¡õ¡õ¡õ¡ö¡ö¡õ¡õ
¡ö¡õ¡õ¡ö¡õ¡ö¡ö¡õ¡õ¡ö¡ö¡õ¡õ¡ö¡õ¡ö¡ö¡ö¡ö¡ö¡õ¡õ¡õ¡ö¡õ¡õ¡õ¡õ¡õ¡õ¡ö¡õ¡õ¡ö¡ö¡õ¡õ¡õ¡ö¡ö¡ö¡ö¡õ¡ö¡ö¡ö¡õ¡õ¡õ¡ö¡ö¡ö¡õ¡ö¡õ¡ö¡õ¡õ
¡õ¡ö¡õ¡õ¡õ¡ö¡õ¡õ¡õ¡ö¡õ¡ö¡õ¡õ¡ö¡ö¡õ¡ö¡õ¡õ¡õ¡ö¡õ¡õ¡ö¡ö¡ö¡ö¡ö¡ö¡ö¡ö¡ö¡ö¡ö¡õ¡ö¡õ¡ö¡ö¡ö¡ö¡õ¡õ¡õ¡ö¡õ¡õ¡ö¡ö¡ö¡õ¡ö¡ö¡ö¡õ¡ö¡õ
¡õ¡õ¡ö¡ö¡ö¡ö¡ö¡õ¡õ¡õ¡ö¡õ¡ö¡ö¡ö¡ö¡õ¡õ¡õ¡ö¡ö¡õ¡ö¡ö¡õ¡ö¡ö¡õ¡ö¡ö¡õ¡õ¡ö¡ö¡õ¡õ¡ö¡õ¡ö¡õ¡ö¡ö¡õ¡ö¡ö¡ö¡ö¡ö¡ö¡õ¡ö¡õ¡õ¡õ¡õ¡ö¡ö¡õ
¡ö¡ö¡ö¡õ¡ö¡ö¡õ¡õ¡ö¡õ¡õ¡õ¡õ¡ö¡õ¡õ¡õ¡ö¡ö¡õ¡ö¡ö¡õ¡ö¡ö¡ö¡õ¡õ¡õ¡ö¡õ¡õ¡õ¡ö¡ö¡ö¡ö¡ö¡õ¡õ¡ö¡õ¡õ¡ö¡ö¡ö¡õ¡õ¡õ¡õ¡ö¡ö¡õ¡õ¡ö¡õ¡ö¡õ
¡ö¡õ¡ö¡ö¡õ¡õ¡õ¡ö¡õ¡õ¡õ¡ö¡ö¡õ¡õ¡ö¡ö¡õ¡õ¡õ¡ö¡õ¡õ¡õ¡õ¡ö¡ö¡ö¡õ¡ö¡õ¡õ¡ö¡ö¡ö¡õ¡õ¡õ¡õ¡õ¡õ¡ö¡ö¡ö¡ö¡ö¡ö¡ö¡ö¡ö¡ö¡ö¡ö¡ö¡ö¡ö¡õ¡ö
¡õ¡õ¡õ¡ö¡ö¡ö¡ö¡õ¡õ¡õ¡ö¡ö¡ö¡õ¡ö¡ö¡ö¡õ¡õ¡õ¡ö¡õ¡ö¡ö¡ö¡õ¡ö¡õ¡õ¡ö¡ö¡õ¡õ¡õ¡ö¡õ¡õ¡ö¡ö¡ö¡õ¡õ¡ö¡õ¡ö¡õ¡õ¡ö¡õ¡ö¡ö¡õ¡õ¡õ¡õ¡ö¡ö¡õ
¡ö¡ö¡ö¡ö¡õ¡õ¡õ¡ö¡ö¡õ¡ö¡õ¡ö¡õ¡õ¡õ¡õ¡õ¡õ¡õ¡ö¡õ¡ö¡õ¡ö¡õ¡ö¡ö¡ö¡ö¡ö¡õ¡ö¡ö¡ö¡ö¡ö¡õ¡õ¡ö¡õ¡õ¡ö¡õ¡õ¡õ¡ö¡ö¡ö¡õ¡ö¡õ¡õ¡ö¡õ¡ö¡õ¡õ
¡ö¡ö¡ö¡ö¡õ¡õ¡õ¡ö¡ö¡ö¡ö¡õ¡õ¡õ¡ö¡ö¡ö¡õ¡ö¡ö¡ö¡ö¡õ¡õ¡ö¡õ¡õ¡õ¡õ¡õ¡õ¡ö¡õ¡õ¡ö¡ö¡ö¡õ¡õ¡õ¡õ¡ö¡õ¡õ¡ö¡õ¡ö¡õ¡õ¡õ¡ö¡õ¡ö¡õ¡ö¡ö¡ö¡õ
¡ö¡ö¡õ¡ö¡ö¡ö¡ö¡ö¡õ¡ö¡õ¡õ¡õ¡ö¡õ¡ö¡õ¡ö¡õ¡ö¡õ¡õ¡õ¡ö¡ö¡ö¡õ¡ö¡ö¡ö¡õ¡õ¡ö¡ö¡õ¡õ¡õ¡ö¡ö¡õ¡ö¡õ¡õ¡õ¡ö¡ö¡ö¡ö¡õ¡õ¡õ¡ö¡õ¡ö¡õ¡ö¡õ¡õ
¡õ¡õ¡ö¡ö¡õ¡õ¡ö¡õ¡õ¡ö¡õ¡ö¡õ¡ö¡ö¡ö¡õ¡ö¡õ¡ö¡õ¡ö¡õ¡ö¡ö¡ö¡ö¡ö¡õ¡ö¡ö¡õ¡õ¡õ¡ö¡ö¡ö¡õ¡ö¡ö¡ö¡ö¡ö¡ö¡õ¡õ¡õ¡õ¡õ¡ö¡ö¡ö¡õ¡õ¡õ¡õ¡ö¡ö
¡õ¡õ¡ö¡ö¡ö¡õ¡õ¡õ¡ö¡õ¡õ¡ö¡õ¡ö¡ö¡õ¡ö¡ö¡õ¡ö¡õ¡õ¡õ¡õ¡õ¡õ¡õ¡õ¡ö¡õ¡õ¡õ¡ö¡ö¡õ¡õ¡ö¡õ¡ö¡õ¡ö¡ö¡õ¡ö¡õ¡ö¡õ¡õ¡õ¡õ¡ö¡õ¡ö¡ö¡ö¡õ¡ö¡õ
¡õ¡õ¡õ¡ö¡õ¡ö¡õ¡õ¡ö¡õ¡ö¡õ¡õ¡ö¡ö¡õ¡ö¡ö¡ö¡õ¡õ¡ö¡ö¡õ¡õ¡ö¡õ¡ö¡õ¡ö¡ö¡õ¡õ¡ö¡õ¡õ¡ö¡õ¡õ¡ö¡ö¡õ¡ö¡ö¡ö¡õ¡õ¡ö¡õ¡õ¡õ¡õ¡õ¡ö¡õ¡õ¡õ¡ö
¡õ¡õ¡õ¡ö¡ö¡õ¡õ¡ö¡õ¡õ¡ö¡ö¡õ¡õ¡õ¡õ¡ö¡ö¡ö¡õ¡ö¡ö¡õ¡õ¡ö¡õ¡õ¡õ¡ö¡ö¡ö¡õ¡ö¡õ¡õ¡õ¡õ¡ö¡õ¡õ¡ö¡õ¡õ¡ö¡õ¡õ¡ö¡ö¡õ¡ö¡ö¡õ¡õ¡õ¡ö¡ö¡ö¡õ
¡ö¡õ¡ö¡ö¡ö¡ö¡ö¡õ¡õ¡õ¡õ¡õ¡õ¡ö¡õ¡ö¡õ¡ö¡õ¡ö¡ö¡ö¡ö¡õ¡ö¡õ¡ö¡ö¡õ¡õ¡õ¡ö¡õ¡ö¡ö¡õ¡ö¡ö¡õ¡õ¡õ¡ö¡õ¡ö¡ö¡ö¡õ¡õ¡ö¡ö¡ö¡õ¡õ¡ö¡ö¡ö¡õ¡ö
¡ö¡ö¡õ¡ö¡õ¡ö¡õ¡õ¡ö¡ö¡õ¡õ¡ö¡ö¡ö¡õ¡õ¡ö¡õ¡õ¡õ¡õ¡ö¡õ¡ö¡ö¡ö¡õ¡ö¡ö¡ö¡ö¡õ¡ö¡ö¡ö¡õ¡ö¡ö¡ö¡ö¡ö¡õ¡õ¡ö¡õ¡õ¡ö¡õ¡õ¡õ¡ö¡õ¡ö¡õ¡õ¡õ¡ö
¡ö¡ö¡õ¡ö¡õ¡õ¡õ¡õ¡õ¡õ¡õ¡õ¡ö¡ù¡ö¡õ¡õ¡ö¡ö¡ö¡ö¡ö¡ö¡ö¡ö¡õ¡õ¡õ¡ö¡ö¡õ¡ö¡õ¡ö¡ö¡õ¡ö¡õ¡õ¡ö¡ö¡ö¡õ¡ö¡õ¡ö¡ö¡õ¡õ¡ö¡õ¡õ¡ö¡ö¡ö¡õ¡õ¡ö
¡õ¡õ¡ö¡ö¡õ¡õ¡ö¡õ¡ö¡õ¡ö¡ö¡ù¡ö¡ö¡õ¡ö¡ö¡õ¡õ¡ö¡õ¡ö¡ö¡ö¡ö¡ö¡õ¡õ¡õ¡ö¡õ¡ö¡õ¡õ¡õ¡ö¡ö¡ö¡ö¡ö¡õ¡ö¡ö¡õ¡ö¡ö¡ö¡õ¡õ¡ö¡ö¡ö¡õ¡õ¡ö¡ö¡õ
¡ö¡ö¡õ¡õ¡ö¡ö¡õ¡ö¡õ¡õ¡ö¡ö¡õ¡ù¡ö¡ö¡õ¡õ¡ö¡ö¡ö¡õ¡õ¡ö¡ö¡õ¡ö¡ö¡ö¡ö¡ö¡õ¡õ¡õ¡õ¡ö¡ö¡õ¡ö¡õ¡ö¡ö¡õ¡ö¡ö¡ö¡ö¡õ¡õ¡õ¡ö¡õ¡õ¡ö¡ö¡ö¡õ¡õ
¡ö¡õ¡ö¡ö¡õ¡õ¡ö¡õ¡ö¡õ¡ö¡ö¡õ¡ù¡õ¡õ¡õ¡ö¡õ¡õ¡õ¡õ¡ö¡ö¡ö¡ö¡õ¡ö¡ö¡ö¡õ¡ö¡ö¡õ¡ö¡ö¡õ¡õ¡õ¡ö¡ö¡ö¡õ¡ö¡ö¡õ¡ö¡ö¡õ¡õ¡õ¡ö¡õ¡õ¡ö¡õ¡ö¡ö
¡õ¡õ¡õ¡õ¡õ¡õ¡õ¡õ¡õ¡ö¡ö¡ö¡ö¡ù¡õ¡ö¡õ¡õ¡ö¡ö¡õ¡õ¡õ¡ö¡õ¡õ¡ö¡ö¡ö¡ö¡ö¡ö¡ö¡ö¡õ¡ö¡ö¡ö¡ö¡õ¡õ¡ö¡ö¡ö¡ö¡ö¡õ¡õ¡õ¡ö¡õ¡ö¡õ¡ö¡õ¡ö¡õ¡ö
¡õ¡ö¡ö¡õ¡õ¡õ¡õ¡ö¡õ¡ö¡õ¡ö¡ù¡ö¡ö¡ö¡ö¡õ¡ö¡ö¡õ¡ö¡ö¡ö¡õ¡ö¡õ¡õ¡ö¡ö¡ö¡õ¡ö¡ö¡ö¡ö¡õ¡ö¡ö¡õ¡ö¡ö¡ö¡õ¡ö¡ö¡õ¡ö¡õ¡õ¡õ¡õ¡ö¡õ¡ö¡õ¡õ¡õ
¡õ¡ö¡õ¡õ¡ö¡ö¡ö¡ö¡ö¡õ¡õ¡õ¡ù¡õ¡õ¡õ¡õ¡ö¡ö¡õ¡õ¡õ¡õ¡ö¡ö¡ö¡õ¡õ¡ö¡õ¡ö¡ö¡ö¡õ¡ö¡ö¡ö¡ö¡õ¡ö¡õ¡õ¡õ¡õ¡õ¡ö¡õ¡õ¡õ¡õ¡õ¡ö¡ö¡õ¡ö¡õ¡õ¡õ
¡õ¡õ¡õ¡õ¡ö¡ö¡õ¡ö¡õ¡ö¡õ¡õ¡ù¡õ¡õ¡õ¡õ¡ö¡õ¡ö¡ö¡õ¡õ¡õ¡õ¡ö¡õ¡õ¡ö¡ö¡ö¡õ¡õ¡õ¡õ¡ö¡õ¡õ¡ö¡õ¡õ¡ö¡õ¡õ¡õ¡ö¡ö¡õ¡ö¡õ¡ö¡ö¡ö¡ö¡ö¡ö¡õ¡ö
¡õ¡ö¡ö¡õ¡ö¡ö¡ö¡ö¡õ¡ö¡õ¡ö¡ù¡õ¡ö¡ö¡õ¡ö¡õ¡õ¡ö¡ö¡ö¡ö¡ö¡ö¡õ¡õ¡ö¡õ¡õ¡õ¡ö¡ö¡õ¡ö¡ö¡õ¡õ¡ö¡ö¡ö¡õ¡õ¡õ¡ö¡ö¡õ¡ö¡ö¡õ¡ö¡ö¡ö¡õ¡õ¡ö¡ö
¡ö¡õ¡õ¡ö¡õ¡õ¡õ¡õ¡ö¡ö¡ö¡ö¡ù¡ö¡ö¡ö¡ö¡õ¡õ¡ö¡õ¡ö¡ö¡õ¡ö¡ö¡õ¡õ¡ö¡ö¡õ¡ö¡ö¡õ¡õ¡õ¡ö¡ö¡õ¡ö¡ö¡ö¡õ¡õ¡ö¡ö¡õ¡ö¡õ¡ö¡ö¡õ¡ö¡ö¡ö¡õ¡õ¡ö
¡ö¡õ¡õ¡ö¡õ¡ö¡õ¡ö¡ö¡ö¡ö¡õ¡ö¡ù¡ù¡õ¡ö¡ö¡ö¡õ¡ö¡ö¡õ¡õ¡õ¡õ¡ö¡ö¡õ¡õ¡õ¡ö¡õ¡ö¡ö¡õ¡ö¡ö¡õ¡ö¡ö¡õ¡ö¡ö¡õ¡õ¡õ¡ö¡õ¡õ¡ö¡ö¡ö¡ö¡ö¡õ¡ö¡ö
¡õ¡ö¡õ¡õ¡õ¡õ¡ö¡ö¡ö¡õ¡õ¡ö¡õ¡ö¡ö¡õ¡ö¡ö¡õ¡ö¡ö¡õ¡õ¡õ¡ö¡ö¡ö¡ö¡ö¡õ¡õ¡õ¡õ¡õ¡õ¡õ¡ö¡ö¡ö¡õ¡õ¡ö¡õ¡ö¡õ¡ö¡õ¡õ¡ö¡ö¡ö¡õ¡ö¡ö¡õ¡õ¡ö¡ö
¡ö¡ö¡õ¡ö¡õ¡ö¡ö¡õ¡õ¡õ¡õ¡ö¡ö¡ö¡ö¡õ¡õ¡ö¡õ¡ö¡ö¡õ¡õ¡õ¡ö¡ö¡õ¡ö¡õ¡õ¡õ¡ö¡õ¡õ¡õ¡ö¡õ¡ö¡õ¡õ¡ö¡õ¡õ¡ö¡ö¡õ¡õ¡õ¡õ¡ö¡õ¡õ¡õ¡ö¡õ¡ö¡ö¡õ
¡õ¡õ¡õ¡ö¡õ¡õ¡ö¡õ¡õ¡ö¡õ¡ö¡õ¡õ¡õ¡õ¡õ¡ö¡õ¡ö¡ö¡õ¡õ¡õ¡ö¡ö¡õ¡ö¡ö¡õ¡õ¡ö¡ö¡ö¡ö¡ö¡õ¡õ¡õ¡õ¡ö¡ö¡ö¡ö¡ö¡ö¡ö¡õ¡õ¡ö¡ö¡õ¡ö¡ö¡õ¡õ¡õ¡õ
¡õ¡õ¡õ¡õ¡ö¡ö¡õ¡ö¡õ¡õ¡õ¡ö¡õ¡ö¡õ¡õ¡õ¡ö¡ö¡õ¡ö¡õ¡õ¡õ¡õ¡ö¡õ¡ö¡õ¡ö¡ö¡ö¡õ¡õ¡õ¡ö¡õ¡õ¡õ¡ö¡õ¡õ¡õ¡õ¡ö¡ö¡ö¡õ¡ö¡ö¡õ¡õ¡õ¡ö¡õ¡õ¡õ¡õ
¡õ¡õ¡õ¡ö¡õ¡ö¡õ¡ö¡õ¡õ¡ö¡ö¡ö¡õ¡õ¡ö¡ö¡õ¡õ¡õ¡õ¡ö¡ö¡ö¡õ¡õ¡ö¡ö¡ö¡õ¡õ¡ö¡õ¡ö¡õ¡õ¡ö¡õ¡ö¡ö¡ö¡ö¡õ¡ö¡ö¡õ¡õ¡õ¡ö¡õ¡õ¡õ¡õ¡ö¡ö¡õ¡õ¡õ
¡ö¡ö¡õ¡ö¡õ¡ö¡ö¡õ¡õ¡ö¡ö¡ö¡õ¡ö¡õ¡ö¡õ¡õ¡õ¡õ¡õ¡ö¡õ¡ö¡ö¡ö¡ö¡ö¡ö¡ö¡ö¡ö¡õ¡õ¡õ¡õ¡ö¡ö¡ö¡õ¡õ¡ö¡ö¡õ¡ö¡ö¡õ¡ö¡ö¡õ¡ö¡õ¡ö¡ö¡ö¡ö¡ö¡õ
¡ö¡ö¡õ¡õ¡ö¡ö¡ö¡õ¡õ¡õ¡õ¡ö¡õ¡õ¡ö¡õ¡õ¡ö¡ö¡õ¡õ¡ö¡ö¡ö¡ö¡õ¡õ¡ö¡õ¡õ¡ö¡ö¡ö¡ö¡ö¡õ¡õ¡õ¡ö¡ö¡ö¡õ¡ö¡õ¡õ¡ö¡õ¡ö¡ö¡õ¡ö¡ö¡ö¡õ¡õ¡ö¡ö¡ö
¡ö¡ö¡ö¡ö¡õ¡õ¡ö¡õ¡õ¡ö¡ö¡ö¡õ¡õ¡õ¡ö¡õ¡õ¡ö¡õ¡õ¡õ¡ö¡ö¡ö¡õ¡ö¡õ¡ö¡õ¡õ¡õ¡ö¡ö¡ö¡õ¡ö¡ö¡õ¡õ¡ö¡ö¡õ¡ö¡ö¡õ¡õ¡ö¡õ¡ö¡õ¡õ¡ö¡ö¡ö¡ö¡õ¡ö
¡õ¡õ¡õ¡õ¡ö¡õ¡ö¡ö¡ö¡õ¡ö¡õ¡õ¡õ¡ö¡õ¡ö¡õ¡ö¡ö¡õ¡ö¡õ¡ö¡õ¡õ¡ö¡õ¡õ¡ö¡ö¡õ¡õ¡õ¡ö¡õ¡ö¡õ¡ö¡ö¡ö¡õ¡õ¡ö¡ö¡ö¡ö¡õ¡ö¡õ¡õ¡õ¡õ¡õ¡ö¡ö¡ö¡õ
¡ö¡ö¡ö¡õ¡õ¡ö¡õ¡ö¡õ¡õ¡ö¡õ¡õ¡õ¡ö¡ö¡õ¡õ¡õ¡õ¡õ¡õ¡õ¡õ¡õ¡ö¡õ¡ö¡õ¡ö¡ö¡ö¡õ¡õ¡õ¡õ¡õ¡ö¡ö¡õ¡õ¡õ¡õ¡õ¡ö¡ö¡ö¡õ¡õ¡ö¡ö¡õ¡õ¡õ¡õ¡õ¡õ¡õ
¡ö¡ö¡ö¡õ¡ö¡õ¡ö¡õ¡ö¡õ¡õ¡õ¡ö¡õ¡õ¡õ¡ö¡ö¡õ¡õ¡ö¡ö¡ö¡õ¡ö¡ö¡ö¡ö¡õ¡ö¡ö¡ö¡ö¡ö¡õ¡õ¡ö¡õ¡ö¡ö¡ö¡ö¡õ¡ö¡õ¡õ¡ö¡õ¡ö¡ö¡õ¡õ¡ö¡ö¡õ¡õ¡õ¡õ
¡ö¡õ¡ö¡ö¡õ¡õ¡õ¡õ¡õ¡õ¡ö¡õ¡õ¡õ¡õ¡õ¡ö¡õ¡õ¡ö¡ö¡õ¡ö¡ö¡ö¡ö¡ö¡õ¡ö¡ö¡õ¡õ¡õ¡ö¡ö¡õ¡õ¡ö¡ö¡õ¡õ¡õ¡õ¡ö¡õ¡õ¡õ¡õ¡ö¡õ¡õ¡õ¡õ¡õ¡ö¡õ¡õ¡ö
¡ö¡õ¡õ¡ö¡õ¡õ¡õ¡õ¡õ¡ö¡ö¡õ¡õ¡õ¡õ¡õ¡õ¡õ¡õ¡ö¡õ¡ö¡õ¡õ¡õ¡ö¡ö¡ö¡ö¡ö¡õ¡õ¡ö¡õ¡ö¡õ¡õ¡õ¡ö¡ö¡õ¡ö¡ö¡õ¡õ¡õ¡ö¡ö¡ö¡ö¡ö¡ö¡õ¡õ¡õ¡õ¡õ¡ö
¡ö¡ö¡õ¡ö¡ö¡õ¡ö¡ö¡õ¡õ¡õ¡õ¡ö¡õ¡ö¡õ¡ö¡ö¡ö¡õ¡õ¡õ¡õ¡ö¡ö¡õ¡ö¡ö¡õ¡ö¡ö¡ö¡õ¡ö¡ö¡õ¡õ¡ö¡õ¡õ¡ö¡ö¡ö¡õ¡õ¡õ¡õ¡õ¡õ¡õ¡ö¡ö¡ö¡ö¡õ¡õ¡õ¡õ
¡ö¡ö¡õ¡ö¡ö¡õ¡ö¡õ¡ö¡ö¡ö¡õ¡ö¡õ¡õ¡ö¡ö¡õ¡ö¡õ¡õ¡õ¡õ¡õ¡ö¡õ¡õ¡ö¡õ¡õ¡ö¡õ¡õ¡õ¡õ¡õ¡ö¡ö¡ö¡õ¡õ¡õ¡ö¡ö¡õ¡ö¡ö¡ö¡õ¡ö¡ö¡õ¡ö¡õ¡õ¡ö¡ö¡õ
¡õ¡õ¡ö¡õ¡õ¡õ¡ö¡ö¡ö¡ö¡õ¡ö¡õ¡ö¡õ¡ö¡ö¡ö¡ö¡ö¡õ¡ö¡ö¡ö¡ö¡ö¡ö¡ö¡ö¡ö¡ö¡õ¡õ¡ö¡õ¡ö¡ö¡ö¡õ¡ö¡õ¡õ¡ö¡ö¡ö¡ö¡ö¡ö¡ö¡ö¡ö¡õ¡õ¡ö¡õ¡ö¡ö¡ö
¡ö¡õ¡ö¡ö¡õ¡õ¡ö¡õ¡õ¡ö¡õ¡ö¡ö¡õ¡ö¡ö¡õ¡ö¡ö¡õ¡ö¡ö¡õ¡ö¡õ¡ö¡õ¡ö¡õ¡ö¡õ¡õ¡ö¡õ¡ö¡õ¡ö¡õ¡õ¡ö¡õ¡õ¡õ¡ö¡ö¡ö¡ö¡õ¡ö¡õ¡õ¡ö¡õ¡õ¡ö¡ö¡õ¡õ
¡ö¡ö¡ö¡ö¡õ¡õ¡ö¡õ¡õ¡õ¡ö¡õ¡ö¡õ¡ö¡ö¡õ¡ö¡õ¡õ¡ö¡ö¡õ¡ö¡ö¡õ¡õ¡ö¡õ¡õ¡ö¡ö¡ö¡ö¡ö¡õ¡ö¡ö¡õ¡ö¡õ¡õ¡ö¡ö¡õ¡õ¡ö¡õ¡õ¡õ¡õ¡õ¡ö¡ö¡õ¡ö¡õ¡ö
¡ö¡õ¡õ¡ö¡õ¡õ¡õ¡ö¡ö¡ö¡ö¡õ¡õ¡õ¡ö¡õ¡õ¡õ¡õ¡ö¡õ¡õ¡ö¡õ¡õ¡ö¡õ¡ö¡õ¡ö¡õ¡õ¡ö¡ö¡õ¡õ¡õ¡ö¡ö¡ö¡ö¡õ¡ö¡ö¡õ¡ö¡õ¡õ¡ö¡õ¡õ¡ö¡õ¡ö¡õ¡õ¡õ¡õ
¡ö¡ö¡ö¡õ¡õ¡ö¡ö¡ö¡õ¡õ¡ö¡ö¡ö¡ö¡ö¡ö¡ö¡ö¡õ¡ö¡õ¡õ¡ö¡õ¡ö¡ö¡õ¡ö¡ö¡õ¡ö¡õ¡õ¡õ¡ö¡ö¡õ¡õ¡õ¡õ¡ö¡ö¡ö¡õ¡õ¡õ¡õ¡ö¡ö¡ö¡õ¡ö¡õ¡õ¡ö¡õ¡ö¡ö
¡ö¡õ¡ö¡ö¡ö¡õ¡ö¡õ¡ö¡ö¡ö¡ö¡ö¡ö¡ö¡ö¡õ¡ö¡ö¡õ¡ö¡õ¡õ¡ö¡ö¡õ¡ö¡õ¡ö¡õ¡õ¡ö¡ö¡õ¡õ¡ö¡õ¡ö¡ö¡ö¡ö¡ö¡õ¡õ¡õ¡ö¡ö¡õ¡ö¡ö¡ö¡ö¡ö¡ö¡ö¡ö¡ö¡ö
¡ö¡ö¡ö¡ö¡õ¡ö¡õ¡õ¡ö¡õ¡ö¡õ¡ö¡ö¡ö¡ö¡ö¡ö¡ö¡ö¡õ¡õ¡ö¡õ¡õ¡ö¡ö¡ö¡õ¡ö¡õ¡ö¡õ¡ö¡ö¡ö¡ö¡ö¡õ¡ö¡ö¡õ¡õ¡õ¡õ¡õ¡õ¡õ¡õ¡ö¡ö¡õ¡õ¡ö¡õ¡õ¡ö¡õ
